amac senior organization	amac insurance for seniors	0
rockauto	rockauto auto parts	1
the home depot	home depot home	1
amazon	amazon books store	0
email login	log into your email	1
youtube	tvyoutube	0
homes for sale near me	property for sale near me 	1
lowes	lowes home improvement s	1
walmart	wal art  	0
staples	staples home office 	0
guitar center near me	guitarcenter com  	1
gnc store	gnc com  	0
how to write a cover letter	create a cover letter for a resume  	0
walgreens	walgreens at 	1
furnitureland south high point nc	furnitureland south high point 	1
low thyroid symptoms in women	symptoms of low thyroid in women  	1
how to be a chef	to become a chef 	1
hotels near atlanta ga	hotels atlanta georgia  	1
walmart com	walmart  	1
discount new balance shoes	new balance discount  	0
turbotax website	turbo tax  	1
five nine	five to nine  	0
red lobster	www red lobster  	1
what is accident forgiveness	accident forgiveness  	1
mcdonald's near me	mcdonalds near by  	1
costco optical department	costco eyewear 	0
biofire respiratory panel	biofire respiratory panels  	1
state farm	farmers state insurance 	0
vmware 10 download	vmware workstation 10 download  	0
total wireless	tracfone wireless  	0
free webinar	free webinar service providers 	0
carrollton senior center	senior living center carrollton 	0
bank	onlinebanks  	0
brother pt 500	pt e500 brother 	1
couponcabin llc	couponcabin  	1
rooms to go furniture	rooms to go 	1
recipes for baked ziti	best baked ziti recipe  	1
overstock com	overstock  	1
walmart online shopping	walmart online shopping walmart 	1
lowes promo codes for online purchases	lowes com promotional codes  	1
lego camping	legos camping  	1
lamere	la mer  	0
ge service appointment	ge service repair 	0
sba disaster assistance	sba disaster assistance loans 	0
autozone	www autozone 	1